Haley - Tik Tok 
Stefan Xuereb - What Do You Want? 
Clintess - Lura Qatt 
Fabrizio Faniello - Try to Be Better 
Eliana Gomez Blanco - Guess What 
Christian Arding - Eku Ċar 
Jason Scerri - Anything Can Happen 
Maria Debono - X'allegrija 
Geo Debono - The Mirror 
Mikhail - Leħen Fiċ-Ċpar 
Aidan - Reġina 
Nathan - Creeping Walls 
Klinsmann - Piranha 
Francesca Sciberras - Masquerade 
The Busker - Dance (Our Own Party) 
Lyndsay - Haunted 
Maxine Pace - Alone 
Marie Claire - Thankful 
Ian - On My Own 
Kirstie - Girls Get Down 
Dario Bezzina - Bridle Road 
Brooke - Checkmate 
Mark Anthony Bartolo - Tears 
Dan - It'll be OK 
Dario - Pawn in a Game 
Matt Blxck - Up 
Andre' - Broken Hill 
Bradley Debono - Blackout 
Cheryl Balzan - La La Land 
Chris Grech - Indescribable 
Dominic & Anna - Whatever Wind May Blow 
Giada - I Depend on You 
Greta Tude - Sound of My Stilettos 
Jake - Love You Like That 
James Louis - Dream 
Jessika - Unapologetic 
John Galea - Trailblazer 
Maria Christina - Our Flame 
Ryan Hili - In the Silence 
Stefan Galea - Heartbreaker
