Rūta Mur – So Low
Gabrielius Vagelis – Šauksmas
Alen Chicco – Do You
Justė Kraujelytė – Need More Fun
Noy – Destiny's Child
Paulina Paukštaitytė – Let Me Think About Me
Il Senso – Sparnai
Joseph June – Vacuum
Baiba – When the Lights Go Out
Luknė – Paradise
Justa Rubežiūtė – When I'll Find
Aistė Pilvelytė – We're Not Running
Multiks – London
Justin 3 feat. Dj AugustYno – Not Giving Up
W.I – You Can Not
Agnė - New Start 
Antikvariniai Kašpirovskio dantys - Sėdi ir važiuoji
Beatrich - Like a Movie
Donata - Dreamer 
Gebrasy - Saw Your Ghost
I. T. - Žinau, tai tu
Mario Junes - Do What You Do
Matt Len - Midnight Train
Melona - Song Of Whispers
Monika Linkytė - Stay
MoonBee - Rumor
Petunija - Love of my life 
The Pixls - Šaukt
Viktorija Faith - If You Ever Miss Me 
Voldemaras Petersonas - Things