Adem Mehmedović - Osmeh
Aleksandar Simić & Nenad Osmanović - Viva la vida
Angellina - Lanac
Boris Subotić - Nedostupan
Chegi & Braća Bluz Band - Svadba ili kavga
Doris Milošević - Tišina
Drai - Loše procene
Dzipsii - Greh
Eegor - Starac dana
Empathy Soul Project - Indigo
Filarri - Posle mene
Filip Baloš - Novi plan drugi san
Filip Žmaher - Čujemo se sutra
Frajle - Neka, neka
Gift - Liberta
Hercenšlus - Vremenska zona
Hurricane - Zumi zimi zami
Igor Stanojević - Iza duge
Igor Vins & Bane Lalić - Zato što volim
Ivona - U noćima
Jovana Tomašević - Kao grom iz vedra neba
Luke Black - Samo mi se spava
Mattia Zanatta - Novi svet
Milan Bujaković, Zoran Todorović & Sanja Anastasija - Fenomen
Nađa - Moj prvi ožiljak na duši
Nađa Terzić - Devojka tvog dečka
Petar Pupić - Ako shvatim
Savo Perović - Presidente
Stefan Maljković Shy - Od jastuka do jastuka
Stefan Zdravković - Cvet sa Istoka
Tijana Dapčević - Mamim
Zejna - Rumba