Y-Limit - Live in Harmony
Victor Gulick - Let’s Dance
Vera - Vremea ta
Valeria Condrea - We’re now different
Tania Pituşcan - Mioriţa
Surorile Osoianu - Bade, bădişor, bădiţă
Sunstroke Project - Yummy Mommy
Sasha Bognibov - My Favourite Schoolgirl
Rise - Don’t trumble
Ricky Ardezianu - Una rosa rossa
Pasha Parfeni - Soarele şi luna
OL - Why You Play It Cool
NÖRDIKA - Skueeze Paradise
NÖRDIKA - Damn and down
NR - Adio
Nino - It would be nice
Nikko T - Destiny
Nihilist & Lisa Nicky - Final Destination
Massimo Sinceri - In Questo Domani
Lola - Temperatura
Lisa Volk - Scrisoare către ţară
Harmony Scuffle - Favourite One
Gesica Sîrbu - I’m in love
Formaţia Vele - Jocul neamului moldovenesc
Donia - Red Zone
Diana Elmas - Miracle
Crista - Pădure verde pădure
Cosmina - Indestructible
Corina Ivanov - When Love’s Real
Angel Kiss - Now I Know
Aliona Moon - Du-mă
Adelina Iordachi - Deja Vu
Ada Deea - Mystic Rose